█████████████████████
█ █   █   █ █ █     █
█ █ █████ █ █ █ █████
█   █   █   █       █
███ █ ███ ███ █ █████
█             █   █ █
███ ███████ ███ ███ █
█         █ █ █ █   █
███ █████ ███ ███ ███
█     █ █     █     █
█ █ ███ █████ █ █████
█ █       █ █   █   █
█ ███ █ █ █ ███ █ ███
█ █   █ █     █     █
█ █ █ █ █ █ ███ ███ █
█ █ █ █ █ █ █   █ █ █
█ ███ ███ █████ █ █ █
█ █     █     █   █ █
█████ █ █ █ █ █████ █
█     █ █ █ █ █     █
█████████████████████